0000 0000 0000 0000 0000 0000 0000 0000 0000 0000 0000 0000 0000 0000 0000 0000 0000 0000 0000 0000 0000 0000 0000 0000 0000 0000 0000 0000 0000 0000 0000 0000 0000 0000 0000 0000 0000 0000 0000 0000 
0000 0000 0000 0000 0000 0000 0000 0000 0000 0000 0000 0000 0000 0000 0000 0000 0000 0000 0000 0000 0000 0000 0000 0000 0000 0000 0000 0000 0000 0000 0000 0000 0000 0000 0000 0000 0000 0000 0000 0000 
0000 0000 0001 0001 0001 0001 0001 0001 0001 0001 0001 0001 0000 0001 0001 0001 0001 0000 0001 0001 0001 0001 0001 0001 0001 0001 0001 0001 0001 0001 0000 0001 0001 0001 0001 0001 0001 0001 0000 0000 
0000 0000 0001 0002 0002 0002 0002 0002 0002 0002 0002 0002 0000 0002 0002 0002 0001 0000 0001 0002 0002 0002 0002 0002 0002 0002 0002 0002 0002 0001 0000 0001 0002 0002 0002 0002 0002 0001 0000 0000 
0000 0000 0001 0002 0002 0002 0002 0002 0002 0002 0002 0002 0000 0002 0103 0002 0001 0000 0001 0002 0002 0002 0002 0002 0002 0002 0002 0002 0002 0001 0000 0001 0002 0002 0002 0002 0002 0001 0000 0000 
0000 0000 0001 0002 0002 0002 0002 0002 0002 0002 0002 0002 0000 0002 0002 0002 0001 0000 0001 0002 0002 0002 0002 0002 0002 0002 0002 0002 0002 0001 0000 0001 0002 0002 0002 0002 0002 0001 0000 0000 
0000 0000 0001 0002 0002 0002 0002 0002 0002 0002 0002 0002 0000 0002 0002 0002 0001 0000 0001 0002 0002 0002 0001 0001 0001 0002 0002 0002 0002 0001 0000 0001 0002 0002 0002 0002 0002 0001 0000 0000 
0000 0000 0104 0002 0002 0002 0002 0002 0002 0002 0002 0002 0000 0002 0002 0002 0001 0000 0001 0002 0002 0002 0001 0000 0001 0002 0002 0002 0002 0001 0000 0001 0002 0002 0002 0002 0002 0001 0000 0000 
0000 0000 0001 0002 0002 0002 0002 0002 0002 0002 0002 0002 0000 0002 0002 0002 0001 0000 0001 0002 0002 0002 0001 0000 0001 0002 0002 0002 0002 0001 0000 0001 0002 0002 0002 0002 0002 0001 0000 0000 
0000 0000 0001 0002 0002 0002 0002 0002 0002 0002 0002 0002 0002 0002 0002 0002 0001 0000 0001 0002 0002 0002 0001 0000 0001 0002 0002 0002 0002 0001 0000 0001 0002 0002 0002 0002 0002 0001 0000 0000 
0000 0000 0001 0002 0002 0002 0002 0002 0002 0002 0002 0002 0002 0002 0002 0002 0001 0000 0001 0002 0002 0002 0001 0000 0001 0002 0002 0002 0002 0001 0000 0001 0002 0002 0002 0002 0002 0001 0000 0000 
0000 0000 0001 0002 0002 0002 0002 0002 0002 0002 0002 0002 0002 0002 0002 0002 0001 0000 0001 0002 0002 0002 0001 0000 0001 0002 0002 0002 0002 0001 0000 0001 0002 0002 0002 0002 0002 0001 0000 0000 
0000 0000 0001 0001 0001 0001 0001 0001 0001 0002 0002 0001 0001 0001 0001 0001 0001 0000 0001 0002 0002 0002 0001 0000 0001 0002 0002 0002 0002 0001 0000 0001 0002 0002 0002 0002 0002 0001 0000 0000 
0000 0000 0000 0000 0000 0000 0000 0000 0001 0204 0204 0001 0000 0000 0000 0000 0000 0000 0001 0002 0002 0002 0001 0000 0001 0002 0002 0002 0002 0001 0000 0001 0002 0002 0002 0002 0002 0001 0000 0000 
0000 0000 0001 0001 0001 0001 0001 0001 0001 0002 0002 0001 0001 0001 0001 0001 0001 0001 0001 0002 0002 0002 0001 0000 0001 0002 0002 0002 0002 0001 0000 0001 0002 0002 0002 0002 0002 0001 0000 0000 
0000 0000 0001 0002 0002 0002 0002 0002 0002 0002 0002 0002 0002 0002 0002 0002 0002 0002 0002 0002 0002 0002 0001 0000 0001 0002 0002 0002 0002 0001 0000 0001 0002 0002 0002 0002 0002 0001 0000 0000 
0000 0000 0001 0002 0002 0002 0002 0002 0002 0002 0002 0002 0002 0002 0002 0002 0002 0002 0002 0002 0002 0002 0001 0000 0001 0002 0002 0002 0002 0001 0000 0001 0002 0002 0002 0002 0002 0001 0000 0000 
0000 0000 0001 0002 0002 0002 0002 0002 0002 0002 0002 0002 0002 0002 0002 0002 0002 0002 0002 0002 0002 0002 0001 0000 0001 0002 0002 0002 0002 0001 0000 0001 0002 0002 0002 0002 0002 0001 0000 0000 
0000 0000 0001 0001 0001 0001 0001 0001 0001 0001 0001 0001 0001 0001 0001 0001 0001 0001 0001 0002 0002 0002 0001 0000 0001 0002 0002 0002 0002 0001 0000 0001 0002 0002 0002 0002 0002 0001 0000 0000 
0000 0000 0001 0000 0000 0000 0000 0000 0000 0000 0000 0000 0000 0000 0000 0000 0000 0000 0000 0002 0002 0002 0001 0000 0001 0002 0002 0002 0002 0001 0000 0001 0002 0002 0002 0002 0002 0001 0000 0000 
0000 0000 0001 0001 0001 0001 0001 0001 0001 0001 0001 0001 0001 0001 0001 0001 0001 0001 0001 0002 0002 0002 0001 0000 0001 0002 0002 0002 0002 0001 0000 0001 0002 0002 0002 0002 0002 0001 0000 0000 
0000 0000 0001 0002 0002 0002 0002 0002 0002 0002 0002 0002 0002 0002 0002 0002 0002 0002 0002 0002 0002 0002 0001 0000 0001 0002 0002 0002 0002 0001 0000 0001 0002 0002 0002 0002 0002 0001 0000 0000 
0000 0000 0001 0002 0002 0002 0002 0002 0002 0002 0002 0002 0002 0002 0002 0002 0002 0002 0002 0002 0002 0002 0001 0000 0001 0002 0002 0002 0002 0001 0000 0001 0002 0002 0002 0002 0002 0001 0000 0000 
0000 0000 0001 0002 0002 0002 0002 0002 0002 0002 0002 0002 0002 0002 0002 0002 0002 0002 0002 0002 0002 0002 0001 0000 0001 0002 0002 0002 0002 0001 0001 0001 0002 0002 0002 0002 0002 0001 0000 0000 
0000 0000 0001 0002 0002 0002 0001 0001 0001 0001 0001 0001 0001 0001 0001 0001 0001 0001 0001 0001 0001 0001 0001 0000 0001 0002 0002 0002 0002 0002 0002 0002 0002 0002 0002 0002 0002 0001 0000 0000 
0000 0000 0001 0002 0203 0002 0001 0000 0000 0000 0000 0000 0000 0000 0000 0000 0000 0000 0000 0000 0000 0000 0000 0000 0001 0002 0002 0002 0002 0002 0002 0002 0002 0002 0002 0002 0002 0001 0000 0000 
0000 0000 0001 0002 0002 0002 0001 0000 0000 0000 0000 0000 0000 0000 0000 0000 0000 0000 0000 0000 0000 0000 0000 0000 0001 0002 0002 0002 0002 0002 0002 0002 0002 0002 0002 0002 0002 0001 0000 0000 
0000 0000 0001 0001 0001 0001 0001 0000 0000 0000 0000 0000 0000 0000 0000 0000 0000 0000 0000 0000 0000 0000 0000 0000 0001 0001 0001 0001 0001 0001 0001 0001 0001 0001 0001 0001 0001 0001 0000 0000 
0000 0000 0000 0000 0000 0000 0000 0000 0000 0000 0000 0000 0000 0000 0000 0000 0000 0000 0000 0000 0000 0000 0000 0000 0000 0000 0000 0000 0000 0000 0000 0000 0000 0000 0000 0000 0000 0000 0000 0000 
0000 0000 0000 0000 0000 0000 0000 0000 0000 0000 0000 0000 0000 0000 0000 0000 0000 0000 0000 0000 0000 0000 0000 0000 0000 0000 0000 0000 0000 0000 0000 0000 0000 0000 0000 0000 0000 0000 0000 0000 
